MAZE: "mylevel", ' '
FLAGS:hardfloor,premapped
MESSAGE: "Welcome to MiniHack!"
INIT_MAP: solidfill,' '
GEOMETRY:center,center
MAP
...........
...........
...........
...........
...........
...........
...........
...........
...........
ENDMAP
$place = { (10,8),(0,8),(10,0) }
SHUFFLE: $place
REGION:(0,0,11,9),lit,"ordinary"
REPLACE_TERRAIN:(0,0,11,9), '.', 'T', 30%
TERRAIN:randline (0,9),(11,0), 5, '.'
TERRAIN:randline (0,0),(11,9), 5, '.'
BRANCH:(0,0,0,0),(1,1,1,1)
STAIR:$place[2],down
